BOBBLEMAP
8							-- Number of rows to load
X11XX00X
X0XXX0XX
X5XXX4XX
X4XXX4XX
X2XXX2XX
X5XXX5XX
X5XXX0XX
X4XXX4XX