BOBBLEMAP
8							-- Number of rows to load
XXX11XXX
XXX0XXXX
XXX5XXXX
XXX0XXXX
XXX2XXXX
XXX4XXXX
XXX2XXXX
XXX0XXXX